player_id,wins,losses,total_comparisons,win_rate,name
328,18702,1103,19805,0.9443069931835395,Mohamed Salah
99,17092,1888,18980,0.9005268703898841,Bryan Mbeumo
182,16176,2406,18582,0.8705198579270261,Cole Palmer
447,15534,2560,18094,0.8585166353487343,Chris Wood
755,6961,1193,8154,0.8536914397841551,Omar Marmoush
770,6069,1076,7145,0.849405178446466,Marshall Munetsi
247,15424,2784,18208,0.8471001757469244,Alex Iwobi
514,15147,2743,17890,0.8466741196198994,Jarrod Bowen
443,15322,2816,18138,0.8447458374682986,Matz Sels
401,15133,2847,17980,0.8416573971078977,Alexander Isak
89,15391,2908,18299,0.8410842122520357,Mikkel Damsgaard
394,15285,2902,18187,0.8404354758893715,Bruno Guimarães Rodriguez Moura
78,15442,2943,18385,0.839923850965461,Antoine Semenyo
110,14955,2946,17901,0.8354281883693648,Yoane Wissa
432,15071,3001,18072,0.8339420097388225,Anthony Elanga
91,15217,3111,18328,0.8302597119161939,Mark Flekken
15,15054,3103,18157,0.8291017238530595,David Raya Martin
54,14966,3168,18134,0.8253005404213081,Morgan Rogers
235,14829,3139,17968,0.8253005342831701,Jordan Pickford
58,14710,3246,17956,0.8192247716640677,Ollie Watkins
585,14863,3299,18162,0.8183570091399626,Ismaïla Sarr
136,14372,3192,17564,0.8182646322022319,Mitoma Kaoru
207,14663,3316,17979,0.8155626008120586,Jean-Philippe Mateta
252,14374,3260,17634,0.8151298627651129,Raúl Jiménez
248,14516,3334,17850,0.8132212885154062,Bernd Leno
402,14536,3423,17959,0.8093991870371402,Jacob Murphy
23,14864,3516,18380,0.8087051142546245,Leandro Trossard
327,14615,3464,18079,0.8083964821063112,Luis Díaz
70,14277,3389,17666,0.8081625721725348,Milos Kerkez
339,14362,3462,17824,0.8057675044883303,Virgil van Dijk
201,14418,3484,17902,0.8053848731985253,Dean Henderson
168,14258,3475,17733,0.8040376698810128,Enzo Fernández
157,14193,3463,17656,0.8038627095604893,Moisés Caicedo Corozo
57,14350,3521,17871,0.8029768899334117,Youri Tielemans
768,5536,1359,6895,0.8029006526468455,Mathys Tel
573,14076,3473,17549,0.8020969855832241,Nikola Milenković
423,14242,3529,17771,0.8014180406279894,Elliot Anderson
366,14630,3676,18306,0.7991915219053862,Bruno Borges Fernandes
106,14033,3528,17561,0.7991002790273902,Kevin Schade
566,13897,3531,17428,0.7973949965572642,Jørgen Strand Larsen
20,13967,3632,17599,0.7936246377635093,Thomas Partey
323,14457,3792,18249,0.7922077922077922,Ryan Gravenberch
98,13912,3663,17575,0.791578947368421,Keane Lewis-Potter
541,13456,3579,17035,0.789903140592897,Matheus Santos Carneiro Da Cunha
222,13566,3774,17340,0.7823529411764706,Idrissa Gueye
350,13530,3830,17360,0.7793778801843319,Joško Gvardiol
623,13078,3712,16790,0.7789160214413341,Mateus Gonçalo Espanha Fernandes
336,13627,3903,17530,0.7773531089560753,Dominik Szoboszlai
268,13346,3838,17184,0.7766527001862198,Liam Delap
306,13357,3842,17199,0.7766149194720623,Jamie Vardy
329,13824,3991,17815,0.7759753017120404,Alexis Mac Allister
71,13344,3887,17231,0.7744181997562533,Justin Kluivert
351,13183,3900,17083,0.771702862494878,Erling Haaland
16,13679,4049,17728,0.7716042418772563,Declan Rice
433,13518,4083,17601,0.7680245440599965,Morgan Gibbs-White
417,13362,4054,17416,0.7672255397335783,Sandro Tonali
525,13090,4003,17093,0.7658105657286609,Mohammed Kudus
372,13132,4052,17184,0.7641992551210428,Alejandro Garnacho
398,13180,4075,17255,0.7638365691104028,Anthony Gordon
342,12993,4072,17065,0.761382947553472,Bernardo Veiga de Carvalho e Silva
436,12862,4036,16898,0.7611551662918689,Murillo Santiago Costa dos Santos
199,13766,4336,18102,0.760468456524141,Eberechi Eze
47,13365,4241,17606,0.7591162103828241,Emiliano Martínez Romero
9,13095,4167,17262,0.7586027111574557,Gabriel Martinelli Silva
383,12840,4105,16945,0.7577456476836825,André Onana
617,12313,4047,16360,0.7526283618581907,Francisco Evanilson de Lima Barbosa
101,12994,4311,17305,0.7508812481941636,Christian Nørgaard
650,11880,3947,15827,0.7506160358880394,Maxence Lacroix
18,12986,4322,17308,0.7502888837531777,William Saliba
210,12866,4377,17243,0.7461578611610509,Tyrick Mitchell
185,12467,4271,16738,0.7448321185326802,Robert Sánchez
88,12640,4360,17000,0.7435294117647059,Nathan Collins
13,12719,4425,17144,0.7418922071861875,Martin Ødegaard
625,12339,4306,16645,0.7413036948032442,Ilkay Gündogan
311,12463,4399,16862,0.7391175424030364,Trent Alexander-Arnold
409,12332,4356,16688,0.7389741131351869,Tino Livramento
392,12575,4444,17019,0.7388800752100594,Harvey Barnes
211,13322,4710,18032,0.7387976929902396,Daniel Muñoz
530,12358,4400,16758,0.7374388351831961,Tomáš Souček
163,12433,4437,16870,0.7369887374036752,Marc Cucurella Saseta
232,12159,4354,16513,0.7363289529461636,Iliman Ndiaye
224,12469,4468,16937,0.7361988545787329,Jack Harrison
492,12202,4420,16622,0.7340873541090122,Dejan Kulusevski
762,5004,1821,6825,0.7331868131868132,Marco Asensio
560,12401,4515,16916,0.7330929297706313,Pedro Lomba Neto
239,12342,4508,16850,0.7324629080118694,Adama Traoré
255,12171,4503,16674,0.7299388269161569,Antonee Robinson
491,12128,4489,16617,0.7298549678040561,Brennan Johnson
177,12208,4520,16728,0.729794356767097,Noni Madueke
321,12312,4611,16923,0.7275305796844531,Cody Gakpo
64,12369,4636,17005,0.7273743016759776,Lewis Cook
19,12050,4528,16578,0.7268669320786585,Emile Smith Rowe
152,12333,4639,16972,0.7266674522743342,Kepa Arrizabalaga
642,11451,4353,15804,0.7245634016704632,André Trindade da Costa Neto
6,12140,4658,16798,0.7227050839385641,Jurriën Timber
434,12012,4613,16625,0.7225263157894737,Callum Hudson-Odoi
146,12360,4774,17134,0.7213727092331038,Bart Verbruggen
231,12186,4709,16895,0.7212784847588044,Vitalii Mykolenko
74,12001,4662,16663,0.7202184480585729,Dango Ouattara
48,12191,4748,16939,0.7197001003601157,John McGinn
553,12112,4719,16831,0.7196245024062742,João Victor Gomes da Silva
148,11770,4613,16383,0.7184276384056644,Danny Welbeck
635,11316,4444,15760,0.718020304568528,Bilal El Khannouss
324,12052,4883,16935,0.7116622379687039,Curtis Jones
388,11979,4854,16833,0.711637854214935,Aaron Wan-Bissaka
533,11935,4846,16781,0.7112210237768906,Rayan Aït-Nouri
274,11546,4703,16249,0.7105668041110222,Omari Giraud-Hutchinson
422,11595,4728,16323,0.7103473626171659,Ola Aina
720,5681,2317,7998,0.710302575643911,Emmanuel Agbadou
594,11598,4745,16343,0.7096616288319159,Noussair Mazraoui
115,11964,4919,16883,0.7086418290588166,Carlos Baleba
503,11535,4760,16295,0.7078858545566125,Son Heung-min
354,11740,4861,16601,0.7071863140774652,Mateo Kovačić
85,11750,4869,16619,0.7070220831578314,Illia Zabarnyi
415,11940,4983,16923,0.7055486615848254,Fabian Schär
494,11433,4851,16284,0.7021002210759028,James Maddison
437,11448,4870,16318,0.7015565633043265,Neco Williams
413,11497,4924,16421,0.7001400645514889,Nick Pope
162,11368,4881,16249,0.6996122838328512,Levi Colwill
395,11858,5099,16957,0.6992982249218612,Dan Burn
535,11577,5018,16595,0.6976197649894547,Jean-Ricner Bellegarde
135,11270,4943,16213,0.6951211990378091,Yankuba Minteh
600,11362,4988,16350,0.6949235474006116,Yasin Ayari
14,11406,5031,16437,0.6939222485855083,Aaron Ramsdale
386,11379,5032,16411,0.6933763938821522,Jadon Sancho
217,11822,5322,17144,0.6895706952869809,Abdoulaye Doucouré
326,11240,5136,16376,0.6863702979970688,Ibrahima Konaté
180,11207,5125,16332,0.6861988733774186,Nicolas Jackson
310,11246,5154,16400,0.6857317073170732,Alisson Ramses Becker
236,11113,5100,16213,0.6854376117930057,James Tarkowski
44,11261,5169,16430,0.685392574558734,Ezri Konsa Ngoyo
3,11017,5093,16110,0.683860955927995,Gabriel dos Santos Magalhães
83,11061,5147,16208,0.6824407699901284,Marcus Tavernier
240,10914,5095,16009,0.681741520394778,Andreas Hoelgebaum Pereira
527,10935,5139,16074,0.6802911534154535,Lucas Tolentino Coelho de Lima
618,10561,5004,15565,0.678509476389335,Georginio Rutter
375,11021,5246,16267,0.6775066084711379,Rasmus Højlund
524,10880,5191,16071,0.6769958309999378,Max Kilman
278,11013,5270,16283,0.676349567033102,Sam Morsy
94,10854,5226,16080,0.675,Vitaly Janelt
619,10521,5091,15612,0.6739046887009992,Jens Cajuste
206,11037,5353,16390,0.67339841366687,Jefferson Lerma Solís
36,10919,5309,16228,0.6728493961054967,Lucas Digne
346,10933,5375,16308,0.6704071621290164,Jérémy Doku
403,10610,5243,15853,0.6692739544565698,Joelinton Cássio Apolinário de Lira
765,4250,2102,6352,0.6690806045340051,Nico González
369,10634,5328,15962,0.6662072422002255,Diogo Dalot Teixeira
764,4137,2073,6210,0.6661835748792271,Alex Palmer
82,10505,5279,15784,0.6655473897617841,Dominic Solanke-Mitchell
219,10805,5466,16271,0.6640649007436543,Jarrad Branthwaite
499,10479,5336,15815,0.6625987986089156,Pape Matar Sarr
452,10491,5370,15861,0.6614337053149234,Joe Aribo
241,10596,5500,16096,0.6583001988071571,Calvin Bassey
345,10608,5513,16121,0.6580236958005087,Kevin De Bruyne
63,10302,5356,15658,0.6579384340273343,Ryan Christie
495,10907,5687,16594,0.6572857659394962,Pedro Porro
192,10273,5433,15706,0.6540812428371323,Jordan Ayew
559,10565,5605,16170,0.6533704390847248,Nélson Cabral Semedo
348,10467,5569,16036,0.6527188825143427,Phil Foden
714,5127,2737,7864,0.6519582909460834,Diego Gómez
364,10179,5458,15637,0.6509560657415105,Amad Diallo
622,9973,5423,15396,0.6477656534164719,Sander Berge
218,10269,5589,15858,0.6475595913734393,Norberto Bercique Gomes Betuncal
17,10227,5579,15806,0.6470327723649247,Bukayo Saka
633,9885,5403,15288,0.646585557299843,Mikel Merino
300,10045,5492,15537,0.6465212074403038,Wilfred Ndidi
251,10154,5562,15716,0.6460931534741664,Rodrigo Muniz Carvalho
757,4208,2318,6526,0.6448053938093778,Michael Kayode
347,10170,5620,15790,0.6440785307156428,Ederson Santana de Moraes
200,11474,6357,17831,0.6434860635971061,Marc Guéhi
249,10070,5580,15650,0.6434504792332268,Saša Lukić
631,9817,5442,15259,0.6433580182187562,Jack Clarke
449,10166,5639,15805,0.6432141727301487,Ryan Yates
335,10687,5933,16620,0.643020457280385,Andrew Robertson
431,10244,5704,15948,0.6423375971908704,Nicolás Domínguez
554,10250,5711,15961,0.6421903389511935,José Malheiro de Sá
53,10289,5733,16022,0.6421795031831232,Jacob Ramsey
129,10249,5730,15979,0.6414043432004506,João Pedro Junqueira de Jesus
608,10139,5687,15826,0.640654618981423,Tyler Dibling
144,10776,6048,16824,0.6405135520684736,Jan Paul van Hecke
571,10132,5752,15884,0.637874590783178,Sávio 'Savinho' Moreira de Oliveira
27,10090,5744,15834,0.6372363268914993,Cameron Archer
356,10021,5733,15754,0.6360924209724514,Matheus Luiz Nunes
126,9863,5706,15569,0.6335024728627401,Jack Hinshelwood
580,9892,5771,15663,0.6315520653770031,Dean Huijsen
317,9933,5917,15850,0.6266876971608832,Diogo Teixeira da Silva
725,4742,2838,7580,0.6255936675461742,Donyell Malen
298,9712,5827,15539,0.6250080442756935,Stephy Mavididi
385,9758,5860,15618,0.6247919067742349,Marcus Rashford
285,9697,5857,15554,0.6234409155201235,Boubakary Soumaré
399,9566,5795,15361,0.6227459149794935,Lewis Hall
238,10383,6312,16695,0.6219227313566936,Ashley Young
513,9858,6007,15865,0.6213677907343208,Alphonse Areola
205,10108,6189,16297,0.6202368534086028,Daichi Kamada
203,9717,6027,15744,0.6171875,Will Hughes
60,9625,5971,15596,0.6171454219030521,Tyler Adams
113,9634,6006,15640,0.6159846547314578,Simon Adingra
389,9510,5959,15469,0.6147779429827397,Joshua Zirkzee
361,9455,6015,15470,0.6111829347123465,Rúben Gato Alves Dias
117,9415,6060,15475,0.6084006462035542,Facundo Buonanotte
32,9546,6189,15735,0.6066730219256434,Matty Cash
159,9234,6074,15308,0.6032140057486282,Trevoh Chalobah
293,9165,6055,15220,0.6021681997371879,Mads Hermansen
171,9202,6139,15341,0.5998305195228473,Malo Gusto
520,9116,6085,15201,0.5996973883297152,Emerson Palmieri dos Santos
548,9150,6183,15333,0.5967521033065937,Gonçalo Manuel Ganchinho Guedes
420,9339,6337,15676,0.5957514672110232,Joe Willock
62,9289,6352,15641,0.5938878588325555,David Brooks
567,9182,6283,15465,0.5937277723892661,Toti António Gomes
338,9036,6216,15252,0.5924468922108576,Sepp van den Berg
233,9071,6280,15351,0.590906129893818,Amadou Onana
42,9136,6399,15535,0.5880914065014483,Boubacar Kamara
654,8292,5838,14130,0.5868365180467091,Carlos Soler
489,8813,6289,15102,0.5835650907164613,Archie Gray
220,8714,6239,14953,0.5827593125125393,Dominic Calvert-Lewin
111,8873,6358,15231,0.5825618803755499,Yehor Yarmoliuk
4,8658,6245,14903,0.5809568543246326,Kai Havertz
543,8899,6448,15347,0.5798527399491757,Matt Doherty
652,8348,6054,14402,0.5796417164282739,Manuel Ugarte
295,8879,6489,15368,0.5777589796980739,James Justin
630,8434,6171,14605,0.5774734679904142,Dara O'Shea
316,8771,6472,15243,0.5754116643705307,Darwin Núñez Ribeiro
259,8573,6343,14916,0.5747519442209708,Harry Wilson
462,8673,6513,15186,0.5711181351244567,Kamaldeen Sulemana
518,8384,6302,14686,0.5708838349448454,Flynn Downes
355,8590,6489,15079,0.5696664235028848,Rico Lewis
792,1919,1452,3371,0.5692672797389499,Jeremy Monga
12,8733,6619,15352,0.5688509640437728,Ethan Nwaneri
596,8582,6513,15095,0.568532626697582,João Pedro Ferreira Silva
230,8428,6414,14842,0.5678479989219781,Dwight McNeil
508,8438,6452,14890,0.5666890530557421,Guglielmo Vicario
593,8203,6451,14654,0.5597788999590555,Matthijs de Ligt
11,8742,6875,15617,0.5597746045975539,Eddie Nketiah
291,8298,6528,14826,0.5596924322136787,Wout Faes
476,8423,6663,15086,0.5583322285562773,Kyle Walker-Peters
455,8188,6551,14739,0.5555329398195265,Jan Bednarek
121,8226,6624,14850,0.553939393939394,Julio Enciso
378,8122,6567,14689,0.5529307645176663,Kobbie Mainoo
122,8630,7013,15643,0.551684459502653,Pervis Estupiñán
480,8206,6690,14896,0.5508861439312567,Rodrigo Bentancur
481,8122,6667,14789,0.5491919670025018,Lucas Bergvall
461,8235,6824,15059,0.5468490603625739,Taylor Harwood-Bellis
531,8308,6908,15216,0.5460042060988434,James Ward-Prowse
281,8188,6812,15000,0.5458666666666666,Jack Taylor
188,7961,6731,14692,0.5418595153825211,Lesley Ugochukwu
340,8118,6889,15007,0.5409475578063571,Manuel Akanji
528,8037,6970,15007,0.5355500766309056,Konstantinos Mavropanos
511,7953,6898,14851,0.5355194936367922,Edson Álvarez Velázquez
81,7683,6767,14450,0.5316955017301038,Adam Smith
181,7735,6832,14567,0.5309947140797694,Christopher Nkunku
577,7770,6911,14681,0.5292555003065186,Jesper Lindstrøm
418,7701,6915,14616,0.5268883415435139,Kieran Trippier
482,7662,6893,14555,0.5264170388182755,Yves Bissouma
45,7811,7073,14884,0.5247917226552002,Ian Maatsen
368,7592,6881,14473,0.5245629793408416,Carlos Henrique Casimiro
267,7918,7209,15127,0.5234349176968335,Leif Davis
772,2975,2709,5684,0.5233990147783252,Willian Borges da Silva
767,2896,2646,5542,0.5225550342836521,Kevin Danso
564,7674,7018,14692,0.5223250748706779,Santiago Bueno
370,7561,6957,14518,0.5208017633282821,Christian Eriksen
591,7505,6919,14424,0.5203133666112035,Jean-Clair Todibo
223,7581,7010,14591,0.5195668562812693,James Garner
629,7118,6651,13769,0.5169583847773985,Matt O'Riley
52,7444,7075,14519,0.5127074867415111,Pau Torres
309,7291,6957,14248,0.5117209432902864,Harry Winks
272,7466,7153,14619,0.5107052465968944,George Hirst
187,7511,7199,14710,0.5106050305914344,Tosin Adarabioyo
149,7394,7154,14548,0.508248556502612,Mats Wieffer
95,7373,7161,14534,0.5072932434292005,Mathias Jensen
191,7648,7436,15084,0.5070273137098913,Joachim Andersen
194,7399,7203,14602,0.5067114093959731,Chris Richards
563,7289,7106,14395,0.5063563737408823,Rodrigo Martins Gomes
257,7136,7003,14139,0.5047033029209986,Kenny Tete
766,2917,2863,5780,0.5046712802768166,Patrick Dorgu
565,7501,7376,14877,0.5042011158163608,Pablo Sarabia
470,7288,7251,14539,0.5012724396450925,Paul Onuachu
28,7257,7304,14561,0.49838609985577914,Leon Bailey
216,7224,7271,14495,0.4983787512935495,Adam Wharton
290,7056,7245,14301,0.4933920704845815,Bobby De Cordova-Reid
244,7046,7353,14399,0.4893395374678797,Timothy Castagne
597,7409,7786,15195,0.4875946034879895,Myles Lewis-Skelly
730,3169,3341,6510,0.48678955453149003,Romain Esse
651,6327,6754,13081,0.4836786178426726,Orel Mangala
645,6741,7220,13961,0.48284506840484204,Justin Devenny
611,6712,7198,13910,0.4825305535585909,Sam Szmodics
474,6994,7518,14512,0.48194597574421166,Sugawara Yukinari
505,6833,7367,14200,0.48119718309859155,Destiny Udogie
424,6817,7418,14235,0.4788900597119775,Taiwo Awoniyi
289,6806,7422,14228,0.4783525442788867,Patson Daka
145,6827,7460,14287,0.47784699377056067,Joël Veltman
410,6799,7472,14271,0.4764207133347348,Sean Longstaff
595,6745,7532,14277,0.47243818729424947,Brajan Gruda
265,6577,7351,13928,0.4722142446869615,Conor Chaplin
377,6571,7417,13988,0.46975979410923646,Harry Maguire
582,6633,7516,14149,0.4687963813697081,Jake O'Brien
677,4896,5561,10457,0.468203117528928,Ollie Scarles
798,1258,1443,2701,0.4657534246575342,Jay Robinson
568,6422,7399,13821,0.464655234787642,Arijanet Muric
588,6384,7432,13816,0.4620729588882455,Guido Rodríguez
104,6350,7488,13838,0.4588813412342824,Ethan Pinnock
172,6373,7632,14005,0.4550517672259907,Reece James
380,6203,7516,13719,0.45214665791967346,Lisandro Martínez
243,6324,7674,13998,0.45177882554650667,Tom Cairney
467,6230,7709,13939,0.4469474137312576,Ryan Manning
453,6118,7590,13708,0.4463087248322148,Adam Armstrong
550,6122,7698,13820,0.44298118668596237,Hwang Hee-chan
86,6104,7705,13809,0.4420305597798537,Kristoffer Ajer
296,6138,7849,13987,0.43883606205762493,Victor Kristiansen
653,5743,7351,13094,0.4385978310676646,Felipe Rodrigues da Silva
120,6154,7973,14127,0.43561973525872444,Lewis Dunk
337,6050,7900,13950,0.4336917562724014,Konstantinos Tsimikas
504,6429,8421,14850,0.43292929292929294,Djed Spence
544,5932,7786,13718,0.4324245516839189,Tommy Doyle
8,5978,7915,13893,0.430288634564169,Jakub Kiwior
245,5917,7871,13788,0.42914128227444154,Issa Diop
501,5886,7854,13740,0.4283842794759825,Oliver Skipp
557,5725,7664,13389,0.4275898125326761,Mario Lemina
313,5944,7966,13910,0.42731847591660677,Conor Bradley
797,1146,1539,2685,0.42681564245810055,Jake Evans
262,5919,7975,13894,0.42601122786814455,Nathan Broadhead
270,5788,7900,13688,0.4228521332554062,Jacob Greaves
589,5765,7871,13636,0.4227779407450865,Niclas Füllkrug
349,5826,7990,13816,0.421685002895194,Jack Grealish
498,5830,8021,13851,0.42090823767237023,Cristian Romero
38,5865,8184,14049,0.41746743540465514,Jhon Durán
718,2767,3890,6657,0.4156526964097942,Welington Damascena Santos
359,5697,8062,13759,0.41405625408823316,Kalvin Phillips
612,5552,7975,13527,0.4104383824942707,Wilson Odobert
288,5568,8033,13601,0.4093816631130064,Conor Coady
579,5584,8109,13693,0.4077996056379172,Ryan Sessegnon
569,5550,8246,13796,0.40229051899101187,Jaden Philogene
123,5437,8179,13616,0.3993096357226792,Evan Ferguson
24,5409,8138,13547,0.39927659260352844,Benjamin White
299,5344,8050,13394,0.3989846199790951,Kasey McAteer
29,5409,8206,13615,0.39728240910760193,Ross Barkley
264,5307,8059,13366,0.3970522220559629,Wes Burns
357,5421,8240,13661,0.3968230729814801,James McAtee
587,5288,8057,13345,0.3962532783814163,Crysencio Summerville
105,5216,7989,13205,0.3950018932222643,Mads Roerslev Rasmussen
49,5403,8296,13699,0.3944083509745237,Tyrone Mings
517,5320,8186,13506,0.3938990078483637,Aaron Cresswell
509,5244,8112,13356,0.3926325247079964,Timo Werner
314,5205,8083,13288,0.3917068031306442,Fábio Freitas Gouveia Carvalho
450,5376,8510,13886,0.38715252772576697,Carlos Alcaraz Durán
77,5165,8233,13398,0.38550529929840277,Alex Scott
716,2462,3971,6433,0.38271413026581685,Antonín Kinsky
186,5167,8368,13535,0.38175101588474325,Raheem Sterling
275,5271,8608,13879,0.37978240507241157,Ben Johnson
578,5107,8346,13453,0.37961792908644915,Riccardo Calafiori
471,5037,8298,13335,0.37772778402699664,Will Smallbone
620,4909,8125,13034,0.3766303513886758,Ramón Sosa
282,5268,8725,13993,0.376473951261345,Axel Tuanzebe
521,5020,8417,13437,0.3735952965691747,Łukasz Fabiański
319,5049,8521,13570,0.3720707442888725,Harvey Elliott
226,4930,8360,13290,0.3709556057185854,Tim Iroegbunam
497,4852,8391,13243,0.3663822396737899,Richarlison de Andrade
472,4953,8670,13623,0.36357630477868313,Jack Stephens
421,4903,8624,13527,0.36246026465587344,Callum Wilson
263,4765,8642,13407,0.3554113522786604,Cameron Burgess
776,1751,3187,4938,0.35459700283515594,Chido Obi-Martin
131,4771,8702,13473,0.35411563868477697,Tariq Lamptey
320,4754,8746,13500,0.35214814814814815,Endo Wataru
65,4600,8467,13067,0.352031835922553,Enes Ünal
382,4605,8539,13144,0.3503499695678637,Mason Mount
572,4737,8789,13526,0.3502144018926512,Leny Yoro
516,4659,8655,13314,0.3499324019828752,Vladimír Coufal
512,4460,8290,12750,0.34980392156862744,Michail Antonio
358,4588,8528,13116,0.34980176883196096,Stefan Ortega Moreno
79,4491,8415,12906,0.34797768479776847,Marcos Senesi
376,4510,8609,13119,0.3437762024544554,Victor Lindelöf
484,4718,9053,13771,0.3426040229467722,Ben Davies
174,4461,8560,13021,0.34260041471469166,Roméo Lavia
147,4560,8759,13319,0.34236804564907275,Adam Webster
731,2006,3876,5882,0.34104046242774566,Andrés García
523,4432,8564,12996,0.34102800861803634,Danny Ings
301,4429,8570,12999,0.3407185168089853,Caleb Okoli
26,4337,8569,12906,0.3360452502711917,Álex Moreno Lopera
25,4399,8730,13129,0.33505979130169855,Oleksandr Zinchenko
396,4316,8655,12971,0.3327422712204148,Martin Dúbravka
325,4284,8683,12967,0.33037711112824864,Caoimhin Kelleher
696,2643,5368,8011,0.32992135813256773,Tyrique George
228,4335,8882,13217,0.3279866838162972,Michael Keane
457,4200,8746,12946,0.3244245326741851,James Bree
2,4125,8767,12892,0.3199658703071672,Gabriel Fernando de Jesus
21,4192,8938,13130,0.3192688499619193,Kieran Tierney
69,4117,8815,12932,0.3183575626353232,Daniel Jebbison
305,4008,8864,12872,0.3113735239279055,Luke Thomas
7,3976,8855,12831,0.3098745226404801,Jorge Luiz Frello Filho
442,3983,8897,12880,0.3092391304347826,Ibrahim Sangaré
10,3800,8800,12600,0.30158730158730157,Reiss Nelson
732,1750,4082,5832,0.3000685871056241,Abdukodir Khusanov
304,3728,8894,12622,0.2953573126287435,Jakub Stolarczyk
167,3788,9077,12865,0.29444228527011274,Axel Disasi
590,3765,9077,12842,0.2931786326117427,William Osula
189,3644,8838,12482,0.29194039416760137,Wesley Fofana
570,3607,8753,12360,0.2918284789644013,Abdul Fatawu
411,3740,9119,12859,0.290846877673225,Lewis Miley
486,3713,9056,12769,0.2907823635366904,Radu Drăgușin
506,3625,8881,12506,0.2898608667839437,Micky van de Ven
607,3657,9136,12793,0.285859454389119,Nico O'Reilly
193,3541,9165,12706,0.27868723437745946,Cheick Doucouré
166,3465,9119,12584,0.27534965034965037,Kiernan Dewsbury-Hall
621,3259,8812,12071,0.26998591665976307,João Félix Sequeira
473,3354,9165,12519,0.26791277258566976,Ross Stewart
80,3278,9079,12357,0.26527474306061344,Luis Sinisterra
526,3313,9231,12544,0.2641103316326531,Luis Guilherme Lira dos Santos
542,3367,9444,12811,0.2628210131917883,Craig Dawson
610,3246,9197,12443,0.2608695652173913,Mikey Moore
405,3221,9225,12446,0.25879800739193315,Emil Krafth
463,3187,9232,12419,0.25662291649891295,Adam Lallana
734,1340,3942,5282,0.25369178341537296,Albert Grønbæk
284,3117,9197,12314,0.2531265226571382,Luke Woolfenden
196,3242,9585,12827,0.25274810945661497,Nathaniel Clyne
277,3049,9235,12284,0.2482090524259199,Massimo Luongo
128,3034,9224,12258,0.24751182900962637,Igor Julio dos Santos de Paulo
341,3048,9363,12411,0.24558859076625575,Nathan Aké
362,3013,9351,12364,0.24369136201876415,John Stones
769,1117,3490,4607,0.24245713045365747,Nasser Djiga
363,2889,9369,12258,0.2356828193832599,Kyle Walker
333,2981,9826,12807,0.23276333255251033,Jarell Quansah
214,2877,9510,12387,0.23225962702833616,Jeffrey Schlupp
156,2862,9463,12325,0.23221095334685599,Armando Broja
68,2806,9479,12285,0.2284086284086284,James Hill
234,2783,9517,12300,0.226260162601626,Nathan Patterson
307,2914,9979,12893,0.22601411618707826,Jannik Vestergaard
592,2725,9332,12057,0.2260097868458157,Julián Araujo Zúñiga
581,2743,9461,12204,0.2247623729924615,Filip Jørgensen
584,2682,9281,11963,0.2241912563738193,Ben Brereton Díaz
674,2087,7262,9349,0.2232324312760723,Paris Maghoma
31,2701,9658,12359,0.21854518974027023,Emiliano Buendía Stati
35,2649,9607,12256,0.21613903394255873,Diego Carlos Santos Silva
97,2603,9571,12174,0.21381632988335797,Yunus Emre Konak
429,2593,9577,12170,0.21306491372226788,Danilo dos Santos de Oliveira
488,2504,9497,12001,0.2086492792267311,Fraser Forster
302,2526,9608,12134,0.20817537497939673,Ricardo Barbosa Pereira
393,2537,9662,12199,0.2079678662185425,Sven Botman
254,2470,9525,11995,0.2059191329720717,Harrison Reed
322,2456,9707,12163,0.20192386746690782,Joe Gomez
76,2383,9571,11954,0.1993474987451899,Philip Billing
655,2195,8841,11036,0.19889452700253715,Carlos Roberto Forbs Borges
576,2337,9673,12010,0.1945878434637802,Andy Irving
604,2314,9702,12016,0.19257656458055925,Josh King
204,2271,9574,11845,0.19172646686365555,Sam Johnstone
404,2277,9654,11931,0.1908473723912497,Lloyd Kelly
391,2279,9665,11944,0.1908070997990623,Miguel Almirón Rejala
84,2265,9631,11896,0.19040013449899126,Mark Travers
107,2236,9737,11973,0.18675352877307275,Igor Thiago Nascimento Rodrigues
583,2217,9746,11963,0.18532140767366045,Conor Townsend
586,2221,9766,11987,0.18528405772920664,Jorge Cuenca Barreno
477,2027,9805,11832,0.17131507775524002,Nathan Wood-Gordon
365,1978,9811,11789,0.16778352701671048,Antony Matheus dos Santos
371,1969,9784,11753,0.1675316940355654,Jonny Evans
160,2015,10040,12055,0.1671505599336375,Ben Chilwell
397,1973,9989,11962,0.16493897341581676,Ryan Fraser
260,1937,9823,11760,0.1647108843537415,Ali Al-Hamadi
283,1914,9769,11683,0.1638277839595994,Christian Walton
598,1924,10041,11965,0.1608023401587965,Lamare Bogarde
469,1866,9816,11682,0.15973292244478685,Alex McCarthy
636,1798,9521,11319,0.1588479547663221,Federico Chiesa
713,902,4786,5688,0.15857946554149085,Julio Soler
628,1721,9292,11013,0.15626986288931263,Ferdi Kadioglu
132,1828,10008,11836,0.15444406894221022,Solly March
387,1784,10263,12047,0.14808666057939737,Luke Shaw
179,1683,9933,11616,0.14488636363636365,Mykhailo Mudryk
475,1716,10173,11889,0.14433509967196567,Charlie Taylor
795,306,1896,2202,0.13896457765667575,Harry Howell
687,1101,6870,7971,0.13812570568310123,Ben Winterburn
632,1483,9397,10880,0.13630514705882352,Chiedozie Ogbene
613,1579,10074,11653,0.1355015875740153,Toby Collyer
697,956,6126,7082,0.134990115786501,Josh Acheampong
198,1552,9959,11511,0.13482755625054296,Odsonne Edouard
796,291,1907,2198,0.13239308462238397,Olabade Aluko
184,1516,9935,11451,0.13239018426338311,Renato Palma Veiga
153,1456,10047,11503,0.126575675910632,Benoît Badiashile
100,1439,10066,11505,0.1250760538896132,Ben Mee
425,1379,10042,11421,0.12074249190088433,Willy Boly
777,514,3747,4261,0.12062896033794884,Tyler Fredricson
266,1384,10341,11725,0.11803837953091685,Harry Clarke
221,1350,10208,11558,0.11680221491607544,Séamus Coleman
670,1057,7996,9053,0.1167568761736441,Harry Amass
466,1302,10140,11442,0.11379129522810698,Joe Lumley
719,599,4913,5512,0.10867198838896952,Joachim Kayi-Sanda
658,1135,9405,10540,0.10768500948766603,Ayden Heaven
134,1214,10111,11325,0.10719646799116998,James Milner
726,583,4881,5464,0.10669838945827233,Woyo Coulibaly
50,1212,10339,11551,0.1049259804345944,Kosta Nedeljković
92,1187,10266,11453,0.10364096743211386,Rico Henry
367,1169,10246,11415,0.10240911081909768,Altay Bayindir
208,1175,10448,11623,0.10109266110298545,Matheus França de Oliveira
536,1144,10256,11400,0.10035087719298245,Daniel Bentley
51,1142,10465,11607,0.09838890324803998,Robin Olsen
444,1104,10239,11343,0.09732874900819889,Harry Toffolo
500,1085,10307,11392,0.09524227528089887,Dane Scarlett
558,1087,10366,11453,0.09490963066445472,Yerson Mosquera
137,1071,10276,11347,0.09438618136952498,Jakub Moder
634,1010,9782,10792,0.093587842846553,Gustavo Nunes Fernandes Gomes
59,1050,10245,11295,0.09296148738379814,Max Aarons
287,1049,10266,11315,0.09270879363676536,Hamza Choudhury
701,611,6292,6903,0.08851224105461393,Lewis Orford
785,300,3134,3434,0.08736167734420501,Claudio Echeverri
763,363,3851,4214,0.08614143331751305,Eiran Cashin
784,306,3280,3586,0.08533184606804238,Mateus Mané
343,973,10514,11487,0.08470444850700792,Oscar Bobb
73,935,10419,11354,0.08234983265809406,Norberto Murara Neto
781,315,3572,3887,0.08103936197581682,Shumaira Mheuka
258,906,10399,11305,0.08014153029632906,Carlos Vinícius Alves Morais
237,899,10483,11382,0.07898436127218415,Youssef Ramalho Chermiti
142,880,10284,11164,0.07882479398065209,Jason Steele
96,847,10406,11253,0.07526881720430108,Kim Ji-soo
771,316,3893,4209,0.07507721549061534,Mathis Amougou
609,841,10420,11261,0.07468253263475713,Will Lankshear
360,845,10497,11342,0.07450185152530418,Rodrigo 'Rodri' Hernandez
178,828,10389,11217,0.07381652848355175,Marc Guiu Paz
733,330,4600,4930,0.06693711967545639,Vitor de Oliveira Nunes dos Reis
666,596,9001,9597,0.06210274043972075,Caleb Kporha
728,314,4749,5063,0.06201856606754889,Zain Silcott-Duberry
561,677,10498,11175,0.06058165548098434,Pedro Cardoso de Lima
416,671,10561,11232,0.05974002849002849,Matt Targett
496,633,10494,11127,0.056888649231598816,Sergio Reguilón
124,624,10435,11059,0.056424631521837416,Billy Gilmour
605,628,10517,11145,0.056348138178555406,Martial Godo
109,614,10504,11118,0.055225760028782156,Hákon Valdimarsson
379,613,10532,11145,0.05500224315836698,Tyrell Malacia
707,325,5588,5913,0.05496363943852528,Remy Rees-Dottin
646,586,10124,10710,0.054715219421101774,Asher Agbinone
456,606,10550,11156,0.054320544998207244,Armel Bella-Kotchap
308,597,10540,11137,0.053605100116728026,Danny Ward
428,584,10536,11120,0.05251798561151079,Eric da Silva Moreira
709,328,5984,6312,0.051964512040557666,Jayden Danns
603,569,10572,11141,0.05107261466654699,Harrison Armstrong
698,343,6554,6897,0.04973176743511672,Divin Mubama
699,317,6444,6761,0.046886555243307204,Alfie Dorrington
271,497,10516,11013,0.04512848451829656,Marcus Myers-Harness
562,497,10516,11013,0.04512848451829656,Daniel Castelo Podence
381,497,10516,11013,0.04512848451829656,Scott McTominay
102,497,10516,11013,0.04512848451829656,Frank Onyeka
672,322,8213,8535,0.0377270064440539,Jahmai Simpson-Pusey
664,346,9213,9559,0.036196254838372216,Alfie Pond
292,392,10640,11032,0.03553299492385787,Michael Golding
534,388,10647,11035,0.03516085183507023,Boubacar Traoré
660,346,9625,9971,0.03470063183231371,Vítezslav Jaros
215,387,10800,11187,0.03459372485921158,Joel Ward
649,350,9786,10136,0.034530386740331494,Jayden Meghoma
556,379,10646,11025,0.03437641723356009,Tom King
643,351,10072,10423,0.03367552528062938,Kaelan Casey
479,368,10649,11017,0.033402922755741124,Brandon Austin
606,356,10617,10973,0.032443269844162945,Will Alves
602,350,10636,10986,0.03185872929182596,Ryan Trevitt
460,350,10639,10989,0.03185003185003185,Ronnie Edwards
515,348,10630,10978,0.031699763162689014,Maxwel Cornet
22,350,10765,11115,0.03148897885739991,Tomiyasu Takehiro
195,325,10811,11136,0.02918462643678161,Chadi Riad Dnanou
225,312,10693,11005,0.0283507496592458,Mason Holgate
269,310,10631,10941,0.028333790329951557,George Edmundson
459,310,10631,10941,0.028333790329951557,Samuel Edozie
141,304,10643,10947,0.02777016534210286,Jeremy Sarmiento Morante
451,304,10643,10947,0.02777016534210286,Samuel Amo-Ameyaw
537,304,10643,10947,0.02777016534210286,Francisco Jorge Tomás Oliveira
256,304,10643,10947,0.02777016534210286,Jay Stansfield
665,109,9166,9275,0.011752021563342319,Nathan Butler-Oyedeji
627,123,10519,10642,0.011557977823717347,Roman Dixon
715,56,5425,5481,0.010217113665389528,Ben Godfrey
