player_id,wins,losses,total_comparisons,win_rate,name
328,18814,1264,20078,0.9370455224623967,Mohamed Salah
99,17357,2217,19574,0.8867375089404311,Bryan Mbeumo
182,16445,2995,19440,0.8459362139917695,Cole Palmer
447,16081,3096,19177,0.8385566042655264,Chris Wood
755,7156,1468,8624,0.8297773654916512,Omar Marmoush
770,6153,1276,7429,0.8282406784223987,Marshall Munetsi
247,15823,3296,19119,0.8276060463413358,Alex Iwobi
514,15745,3302,19047,0.8266393657793878,Jarrod Bowen
91,15940,3353,19293,0.8262063961022132,Mark Flekken
89,15885,3362,19247,0.8253234270275888,Mikkel Damsgaard
78,15824,3385,19209,0.8237805195481285,Antoine Semenyo
394,15782,3439,19221,0.8210811092034753,Bruno Guimarães Rodriguez Moura
443,15707,3436,19143,0.8205088021731181,Matz Sels
15,15779,3500,19279,0.8184553140723066,David Raya Martin
235,15535,3577,19112,0.8128401004604437,Jordan Pickford
432,15549,3586,19135,0.8125947217141364,Anthony Elanga
110,15440,3618,19058,0.8101584636373177,Yoane Wissa
401,15500,3633,19133,0.8101186431819369,Alexander Isak
54,15482,3837,19319,0.8013872353641492,Morgan Rogers
248,15161,3808,18969,0.7992514101955822,Bernd Leno
136,15104,3814,18918,0.7983930648060049,Mitoma Kaoru
585,15425,3925,19350,0.7971576227390181,Ismaïla Sarr
23,15475,3939,19414,0.7971051818275471,Leandro Trossard
252,14983,3883,18866,0.7941800063606488,Raúl Jiménez
207,15300,3979,19279,0.7936096270553452,Jean-Philippe Mateta
768,5809,1541,7350,0.7903401360544218,Mathys Tel
201,15105,4078,19183,0.7874159411979357,Dean Henderson
58,15110,4108,19218,0.7862420647309813,Ollie Watkins
402,15005,4092,19097,0.785725506624077,Jacob Murphy
106,14778,4076,18854,0.78381245359075,Kevin Schade
366,15027,4151,19178,0.7835540723745958,Bruno Borges Fernandes
327,15067,4163,19230,0.7835153406136246,Luis Díaz
70,14772,4092,18864,0.7830788804071247,Milos Kerkez
423,14793,4141,18934,0.7812929122214006,Elliot Anderson
168,14804,4154,18958,0.7808840594999472,Enzo Fernández
157,14803,4156,18959,0.7807901260615011,Moisés Caicedo Corozo
573,14631,4160,18791,0.7786174232345272,Nikola Milenković
339,14839,4247,19086,0.7774808760347899,Virgil van Dijk
323,14984,4311,19295,0.7765742420316144,Ryan Gravenberch
57,14896,4286,19182,0.7765613596079658,Youri Tielemans
98,14622,4269,18891,0.7740193743052247,Keane Lewis-Potter
20,14638,4338,18976,0.7713954468802698,Thomas Partey
566,14505,4300,18805,0.7713374102632279,Jørgen Strand Larsen
541,14294,4320,18614,0.7679166218974965,Matheus Santos Carneiro Da Cunha
351,14357,4407,18764,0.76513536559369,Erling Haaland
222,14322,4482,18804,0.7616464582003829,Idrissa Gueye
350,14329,4523,18852,0.7600785062592829,Joško Gvardiol
623,13856,4374,18230,0.76006582556226,Mateus Gonçalo Espanha Fernandes
329,14481,4600,19081,0.7589224883391856,Alexis Mac Allister
336,14361,4598,18959,0.7574766601614009,Dominik Szoboszlai
268,14096,4543,18639,0.7562637480551532,Liam Delap
71,14050,4631,18681,0.7521010652534661,Justin Kluivert
433,14197,4697,18894,0.7514025616597861,Morgan Gibbs-White
417,14110,4712,18822,0.7496546594410796,Sandro Tonali
16,14245,4771,19016,0.7491060159865377,Declan Rice
342,14003,4700,18703,0.7487034165641876,Bernardo Veiga de Carvalho e Silva
372,13880,4753,18633,0.7449149358664735,Alejandro Garnacho
199,14355,4930,19285,0.7443609022556391,Eberechi Eze
525,13883,4780,18663,0.7438782618014252,Mohammed Kudus
306,13812,4813,18625,0.7415838926174496,Jamie Vardy
383,13709,4784,18493,0.7413075217649922,André Onana
18,13929,4961,18890,0.7373742721016411,William Saliba
398,13818,4929,18747,0.7370779324691951,Anthony Gordon
617,13256,4756,18012,0.735953808572063,Francisco Evanilson de Lima Barbosa
47,14033,5037,19070,0.7358678552700577,Emiliano Martínez Romero
9,13751,5016,18767,0.7327223317525443,Gabriel Martinelli Silva
101,13744,5015,18759,0.7326616557385788,Christian Nørgaard
650,12751,4691,17442,0.731051484921454,Maxence Lacroix
88,13527,5041,18568,0.7285114174924602,Nathan Collins
392,13542,5118,18660,0.7257234726688103,Harvey Barnes
211,13968,5312,19280,0.7244813278008299,Daniel Muñoz
436,13412,5110,18522,0.7241118669690099,Murillo Santiago Costa dos Santos
530,13369,5127,18496,0.7228049307958477,Tomáš Souček
210,13572,5284,18856,0.7197708952057701,Tyrick Mitchell
311,13374,5273,18647,0.7172199281385746,Trent Alexander-Arnold
224,13359,5280,18639,0.7167230001609528,Jack Harrison
185,13252,5245,18497,0.7164405038654917,Robert Sánchez
13,13460,5339,18799,0.7159955316772169,Martin Ødegaard
231,13252,5328,18580,0.7132400430570506,Vitalii Mykolenko
409,13184,5312,18496,0.71280276816609,Tino Livramento
625,13002,5244,18246,0.7125945412693193,Ilkay Gündogan
239,13144,5303,18447,0.7125277822952242,Adama Traoré
492,13069,5294,18363,0.7117028807928988,Dejan Kulusevski
152,13138,5378,18516,0.709548498595809,Kepa Arrizabalaga
255,12996,5322,18318,0.709466098919096,Antonee Robinson
19,12985,5322,18307,0.7092915278308843,Emile Smith Rowe
642,12411,5087,17498,0.7092810606926506,André Trindade da Costa Neto
232,13028,5360,18388,0.7085055470959322,Iliman Ndiaye
177,13089,5412,18501,0.7074752716069401,Noni Madueke
163,13114,5456,18570,0.7061927840603124,Marc Cucurella Saseta
560,13105,5458,18563,0.7059742498518559,Pedro Lomba Neto
64,13077,5485,18562,0.7045038250188558,Lewis Cook
74,12948,5445,18393,0.7039634643614419,Dango Ouattara
146,13168,5542,18710,0.7037947621592732,Bart Verbruggen
434,12864,5481,18345,0.7012264922322159,Callum Hudson-Odoi
491,12845,5515,18360,0.6996187363834423,Brennan Johnson
553,12912,5552,18464,0.6993067590987868,João Victor Gomes da Silva
388,12929,5563,18492,0.6991672074410555,Aaron Wan-Bissaka
6,12982,5610,18592,0.6982573149741824,Jurriën Timber
354,12899,5584,18483,0.6978845425526159,Mateo Kovačić
762,5231,2284,7515,0.6960745176314038,Marco Asensio
635,12117,5333,17450,0.6943839541547278,Bilal El Khannouss
594,12591,5567,18158,0.6934133715166868,Noussair Mazraoui
321,12954,5746,18700,0.6927272727272727,Cody Gakpo
148,12633,5690,18323,0.689461332751187,Danny Welbeck
115,12773,5806,18579,0.6874966359868669,Carlos Baleba
324,12825,5839,18664,0.6871517359622803,Curtis Jones
48,12861,5878,18739,0.6863226426170019,John McGinn
415,12718,5835,18553,0.6854956071794319,Fabian Schär
533,12639,5813,18452,0.6849663993063082,Rayan Aït-Nouri
494,12471,5747,18218,0.6845427599077835,James Maddison
395,12692,5894,18586,0.6828795867857527,Dan Burn
503,12382,5763,18145,0.6823918434830532,Son Heung-min
386,12488,5834,18322,0.6815849798056981,Jadon Sancho
135,12426,5807,18233,0.6815115450008227,Yankuba Minteh
720,6089,2873,8962,0.6794242356616826,Emmanuel Agbadou
14,12412,5881,18293,0.678510905810966,Aaron Ramsdale
274,12320,5847,18167,0.6781526944459735,Omari Giraud-Hutchinson
422,12360,5880,18240,0.6776315789473685,Ola Aina
413,12439,5949,18388,0.676473787252556,Nick Pope
3,12359,5921,18280,0.6760940919037199,Gabriel dos Santos Magalhães
437,12322,5904,18226,0.6760671568089542,Neco Williams
600,12381,5952,18333,0.6753395516282115,Yasin Ayari
535,12412,5988,18400,0.6745652173913044,Jean-Ricner Bellegarde
85,12375,5977,18352,0.6743134263295554,Illia Zabarnyi
310,12314,6122,18436,0.6679323063571274,Alisson Ramses Becker
764,4664,2327,6991,0.6671434701759404,Alex Palmer
217,12439,6251,18690,0.6655430711610487,Abdoulaye Doucouré
236,12126,6099,18225,0.6653497942386831,James Tarkowski
618,11761,5938,17699,0.6645008192553251,Georginio Rutter
162,12108,6117,18225,0.6643621399176954,Levi Colwill
524,12028,6090,18118,0.6638701843470581,Max Kilman
240,11946,6111,18057,0.6615716896494435,Andreas Hoelgebaum Pereira
44,12196,6262,18458,0.6607433091342507,Ezri Konsa Ngoyo
180,12095,6212,18307,0.6606762440596493,Nicolas Jackson
765,4732,2446,7178,0.6592365561437726,Nico González
83,11961,6202,18163,0.6585365853658537,Marcus Tavernier
375,11971,6219,18190,0.6581088510170423,Rasmus Højlund
326,12044,6326,18370,0.6556341861731083,Ibrahima Konaté
348,11930,6276,18206,0.6552784796221026,Phil Foden
527,11869,6267,18136,0.6544441993824438,Lucas Tolentino Coelho de Lima
94,11877,6286,18163,0.6539117987116666,Vitaly Janelt
278,11834,6319,18153,0.6519032666776842,Sam Morsy
369,11733,6271,18004,0.6516885136636303,Diogo Dalot Teixeira
206,12079,6456,18535,0.6516859994604802,Jefferson Lerma Solís
346,11903,6423,18326,0.6495143511950234,Jérémy Doku
619,11384,6162,17546,0.6488088453208709,Jens Cajuste
82,11591,6356,17947,0.6458461024126595,Dominic Solanke-Mitchell
36,11804,6536,18340,0.6436205016357688,Lucas Digne
403,11632,6449,18081,0.6433272495990267,Joelinton Cássio Apolinário de Lira
452,11581,6422,18003,0.6432816752763428,Joe Aribo
219,11729,6519,18248,0.6427553704515563,Jarrad Branthwaite
241,11582,6455,18037,0.6421245218162666,Calvin Bassey
345,11683,6553,18236,0.6406558455801711,Kevin De Bruyne
499,11483,6461,17944,0.6399353544360232,Pape Matar Sarr
200,12220,6949,19169,0.6374876102039752,Marc Guéhi
633,11049,6284,17333,0.6374545664339699,Mikel Merino
622,11143,6338,17481,0.6374349293518677,Sander Berge
714,5728,3266,8994,0.6368690237936402,Diego Gómez
144,11824,6763,18587,0.636143541184699,Jan Paul van Hecke
251,11370,6510,17880,0.6359060402684564,Rodrigo Muniz Carvalho
63,11382,6524,17906,0.6356528537920251,Ryan Christie
53,11629,6679,18308,0.6351868035831331,Jacob Ramsey
347,11454,6589,18043,0.6348168264700992,Ederson Santana de Moraes
249,11254,6563,17817,0.6316439355671549,Saša Lukić
364,11235,6567,17802,0.6311088641725648,Amad Diallo
631,10820,6337,17157,0.6306463834003614,Jack Clarke
218,11390,6697,18087,0.6297340631392713,Norberto Bercique Gomes Betuncal
192,11258,6662,17920,0.6282366071428571,Jordan Ayew
129,11412,6763,18175,0.6278954607977991,João Pedro Junqueira de Jesus
571,11388,6759,18147,0.6275417424367664,Sávio 'Savinho' Moreira de Oliveira
608,11240,6724,17964,0.6256958361166778,Tyler Dibling
559,11325,6781,18106,0.6254832652159505,Nélson Cabral Semedo
356,11287,6801,18088,0.6240048651039363,Matheus Luiz Nunes
17,11282,6816,18098,0.6233837993148414,Bukayo Saka
495,11460,6925,18385,0.6233342398694588,Pedro Porro
300,11121,6725,17846,0.6231648548694385,Wilfred Ndidi
757,4674,2829,7503,0.6229508196721312,Michael Kayode
27,11141,6820,17961,0.6202884026501865,Cameron Archer
449,11111,6843,17954,0.6188593071181909,Ryan Yates
431,11136,6898,18034,0.6175002772540756,Nicolás Domínguez
513,11119,6917,18036,0.6164892437347527,Alphonse Areola
554,11077,6956,18033,0.6142627405312483,José Malheiro de Sá
385,11119,6991,18110,0.6139701822197681,Marcus Rashford
335,11369,7156,18525,0.6137112010796222,Andrew Robertson
580,10953,6941,17894,0.6121046160724265,Dean Huijsen
238,11270,7180,18450,0.610840108401084,Ashley Young
126,10898,6970,17868,0.6099171703604208,Jack Hinshelwood
317,11061,7084,18145,0.6095894185726095,Diogo Teixeira da Silva
203,11049,7091,18140,0.60909592061742,Will Hughes
285,10809,7006,17815,0.6067358967162504,Boubakary Soumaré
60,10814,7058,17872,0.6050805729632945,Tyler Adams
298,10761,7035,17796,0.6046864463924477,Stephy Mavididi
399,10789,7082,17871,0.603715516758995,Lewis Hall
205,11167,7343,18510,0.6032955159373312,Daichi Kamada
389,10716,7063,17779,0.6027335620676079,Joshua Zirkzee
117,10700,7091,17791,0.6014276881569333,Facundo Buonanotte
361,10744,7158,17902,0.6001564071053513,Rúben Gato Alves Dias
113,10754,7223,17977,0.5982088223841575,Simon Adingra
159,10642,7149,17791,0.5981676128379517,Trevoh Chalobah
233,10675,7275,17950,0.5947075208913649,Amadou Onana
62,10556,7397,17953,0.5879797248370746,David Brooks
725,5135,3611,8746,0.5871255431054196,Donyell Malen
338,10394,7325,17719,0.5866019527061347,Sepp van den Berg
293,10383,7349,17732,0.5855515452289646,Mads Hermansen
420,10501,7471,17972,0.5842977965724461,Joe Willock
32,10577,7551,18128,0.5834620476610768,Matty Cash
520,10310,7402,17712,0.5820912375790425,Emerson Palmieri dos Santos
171,10396,7476,17872,0.5816920322291853,Malo Gusto
548,10303,7451,17754,0.580319927903571,Gonçalo Manuel Ganchinho Guedes
567,10309,7475,17784,0.5796783625730995,Toti António Gomes
111,10220,7492,17712,0.5770099367660343,Yehor Yarmoliuk
42,10392,7639,18031,0.5763407464921524,Boubacar Kamara
4,10111,7566,17677,0.5719861967528427,Kai Havertz
489,10065,7565,17630,0.5709018718094158,Archie Gray
652,9444,7104,16548,0.5707034082668601,Manuel Ugarte
12,10182,7725,17907,0.5686044563578488,Ethan Nwaneri
220,10002,7592,17594,0.5684892577014892,Dominic Calvert-Lewin
355,10038,7624,17662,0.5683388064771826,Rico Lewis
654,9323,7110,16433,0.567334023002495,Carlos Soler
543,9986,7720,17706,0.5639896080424714,Matt Doherty
630,9479,7337,16816,0.5636893434823977,Dara O'Shea
259,9850,7675,17525,0.5620542082738944,Harry Wilson
295,9932,7816,17748,0.5596123506874014,James Justin
518,9741,7702,17443,0.5584475147623689,Flynn Downes
596,9835,7804,17639,0.5575712908895062,João Pedro Ferreira Silva
462,9827,7860,17687,0.5556058121784362,Kamaldeen Sulemana
122,9979,8009,17988,0.5547587280409162,Pervis Estupiñán
230,9743,7827,17570,0.5545247581104155,Dwight McNeil
593,9574,7772,17346,0.5519428110227141,Matthijs de Ligt
508,9646,7834,17480,0.5518306636155607,Guglielmo Vicario
792,2199,1787,3986,0.5516808830908179,Jeremy Monga
531,9780,7953,17733,0.5515141262053798,James Ward-Prowse
316,9828,8010,17838,0.5509586276488395,Darwin Núñez Ribeiro
455,9563,7884,17447,0.5481171548117155,Jan Bednarek
461,9611,7996,17607,0.5458624410745726,Taylor Harwood-Bellis
481,9538,7937,17475,0.5458082975679542,Lucas Bergvall
476,9603,7994,17597,0.5457180201170654,Kyle Walker-Peters
11,9882,8275,18157,0.5442529052156193,Eddie Nketiah
121,9530,7990,17520,0.5439497716894978,Julio Enciso
378,9455,7956,17411,0.5430474987077135,Kobbie Mainoo
291,9489,8008,17497,0.5423215408355718,Wout Faes
480,9463,8040,17503,0.5406501742558418,Rodrigo Bentancur
528,9537,8115,17652,0.5402787219578518,Konstantinos Mavropanos
281,9441,8050,17491,0.5397633068435195,Jack Taylor
340,9535,8153,17688,0.5390660334690185,Manuel Akanji
772,3562,3131,6693,0.532197818616465,Willian Borges da Silva
511,9329,8206,17535,0.5320216709438267,Edson Álvarez Velázquez
577,9288,8173,17461,0.5319282973483764,Jesper Lindstrøm
181,9297,8188,17485,0.5317128967686588,Christopher Nkunku
188,9259,8186,17445,0.5307537976497564,Lesley Ugochukwu
149,9096,8353,17449,0.5212906183735457,Mats Wieffer
591,9014,8283,17297,0.5211308319361739,Jean-Clair Todibo
223,9077,8368,17445,0.5203210088850674,James Garner
482,9002,8303,17305,0.5201964750072233,Yves Bissouma
272,8994,8334,17328,0.5190443213296398,George Hirst
564,9054,8397,17451,0.518824136152656,Santiago Bueno
418,9022,8438,17460,0.5167239404352807,Kieran Trippier
368,8931,8382,17313,0.5158551377577543,Carlos Henrique Casimiro
81,8885,8342,17227,0.5157601439600626,Adam Smith
370,8927,8388,17315,0.5155645394166908,Christian Eriksen
309,8857,8333,17190,0.5152414194299011,Harry Winks
563,8853,8421,17274,0.5125043417853421,Rodrigo Martins Gomes
187,8951,8575,17526,0.5107269200045647,Tosin Adarabioyo
267,8934,8586,17520,0.5099315068493151,Leif Davis
767,3377,3267,6644,0.5082781456953642,Kevin Danso
629,8389,8193,16582,0.5059100229164154,Matt O'Riley
191,8829,8752,17581,0.5021898640577896,Joachim Andersen
290,8657,8593,17250,0.5018550724637681,Bobby De Cordova-Reid
257,8557,8528,17085,0.5008486976880304,Kenny Tete
52,8765,8741,17506,0.5006854792642522,Pau Torres
565,8759,8779,17538,0.4994298095563918,Pablo Sarabia
95,8683,8731,17414,0.49862179855288846,Mathias Jensen
470,8643,8721,17364,0.4977539737387699,Paul Onuachu
244,8561,8670,17231,0.4968370959317509,Timothy Castagne
194,8719,8860,17579,0.49598953296547016,Chris Richards
45,8786,8942,17728,0.49560018050541516,Ian Maatsen
645,8270,8564,16834,0.4912676725674231,Justin Devenny
505,8418,8736,17154,0.490731024833858,Destiny Udogie
216,8601,8940,17541,0.49033692491876174,Adam Wharton
611,8310,8651,16961,0.4899475266788515,Sam Szmodics
798,1629,1718,3347,0.4867045115028384,Jay Robinson
651,7709,8192,15901,0.48481227595748694,Orel Mangala
410,8393,8919,17312,0.4848082255083179,Sean Longstaff
766,3270,3488,6758,0.4838709677419355,Patrick Dorgu
582,8295,8890,17185,0.48268839103869654,Jake O'Brien
289,8278,8872,17150,0.4826822157434402,Patson Daka
145,8337,8975,17312,0.48157347504621073,Joël Veltman
28,8450,9104,17554,0.48137176711860546,Leon Bailey
597,8514,9275,17789,0.47861037719939287,Myles Lewis-Skelly
424,8209,9013,17222,0.4766577633259784,Taiwo Awoniyi
730,3787,4168,7955,0.47605279698302955,Romain Esse
677,6089,6720,12809,0.4753688812553673,Ollie Scarles
104,8060,8928,16988,0.4744525547445255,Ethan Pinnock
377,8085,8959,17044,0.47436047876085424,Harry Maguire
588,8070,8945,17015,0.4742873934763444,Guido Rodríguez
265,8052,8947,16999,0.4736749220542385,Conor Chaplin
568,8014,8936,16950,0.4728023598820059,Arijanet Muric
595,8165,9115,17280,0.47251157407407407,Brajan Gruda
474,8143,9199,17342,0.46955368469611347,Sugawara Yukinari
172,7955,9192,17147,0.46392955035866335,Reece James
380,7805,9074,16879,0.4624089104804787,Lisandro Martínez
453,7822,9186,17008,0.45990122295390407,Adam Armstrong
467,7808,9255,17063,0.4575983121373733,Ryan Manning
86,7779,9276,17055,0.45611257695690416,Kristoffer Ajer
504,7987,9527,17514,0.45603517186250997,Djed Spence
337,7860,9376,17236,0.4560222789510327,Konstantinos Tsimikas
653,7248,8689,15937,0.4547907385329736,Felipe Rodrigues da Silva
120,7843,9407,17250,0.45466666666666666,Lewis Dunk
243,7724,9358,17082,0.45217187682941107,Tom Cairney
550,7672,9360,17032,0.4504462188821043,Hwang Hee-chan
544,7645,9383,17028,0.44896640826873385,Tommy Doyle
245,7529,9362,16891,0.44574033508969274,Issa Diop
270,7492,9323,16815,0.4455545643770443,Jacob Greaves
296,7561,9486,17047,0.44353845251363877,Victor Kristiansen
589,7532,9469,17001,0.4430327627786601,Niclas Füllkrug
349,7556,9545,17101,0.44184550611075374,Jack Grealish
557,7404,9415,16819,0.4402164219037993,Mario Lemina
313,7540,9651,17191,0.4386015938572509,Conor Bradley
8,7501,9639,17140,0.4376312718786464,Jakub Kiwior
262,7414,9528,16942,0.43761067170345885,Nathan Broadhead
24,7380,9551,16931,0.4358868348000709,Benjamin White
718,3605,4704,8309,0.43386689132266215,Welington Damascena Santos
501,7327,9605,16932,0.4327309236947791,Oliver Skipp
498,7354,9650,17004,0.43248647377087746,Cristian Romero
579,7278,9597,16875,0.4312888888888889,Ryan Sessegnon
359,7273,9613,16886,0.43071183228710175,Kalvin Phillips
797,1432,1907,3339,0.42887091943695715,Jake Evans
38,7397,9936,17333,0.426758206888594,Jhon Durán
612,7151,9677,16828,0.42494651770858094,Wilson Odobert
578,7196,9743,16939,0.4248184662612905,Riccardo Calafiori
569,7142,9774,16916,0.4222038306928352,Jaden Philogene
587,7066,9719,16785,0.4209711051534108,Crysencio Summerville
105,7021,9700,16721,0.41989115483523715,Mads Roerslev Rasmussen
288,7069,9773,16842,0.41972449827811426,Conor Coady
509,6974,9722,16696,0.4177048394825108,Timo Werner
275,7068,9886,16954,0.4168927686681609,Ben Johnson
314,6972,9782,16754,0.41613942938999643,Fábio Freitas Gouveia Carvalho
517,7000,9848,16848,0.4154795821462488,Aaron Cresswell
357,7049,9968,17017,0.41423282599753186,James McAtee
299,6922,9816,16738,0.4135500059744294,Kasey McAteer
450,7149,10153,17302,0.41318922667899666,Carlos Alcaraz Durán
123,6988,9936,16924,0.41290475064996457,Evan Ferguson
186,6991,9972,16963,0.4121322879207687,Raheem Sterling
264,6874,9806,16680,0.41211031175059953,Wes Burns
282,6967,10048,17015,0.40946223920070524,Axel Tuanzebe
716,3362,4849,8211,0.4094507368164657,Antonín Kinsky
471,6835,9895,16730,0.4085475194261805,Will Smallbone
77,6807,9916,16723,0.4070441906356515,Alex Scott
49,6882,10260,17142,0.4014700735036752,Tyrone Mings
620,6576,9818,16394,0.40112236183969746,Ramón Sosa
516,6685,10094,16779,0.39841468502294536,Vladimír Coufal
497,6646,10068,16714,0.39763072873040567,Richarlison de Andrade
521,6660,10139,16799,0.39645216977201025,Łukasz Fabiański
29,6764,10333,17097,0.39562496344387904,Ross Barkley
319,6705,10341,17046,0.39334741288278774,Harvey Elliott
382,6524,10166,16690,0.3908927501497903,Mason Mount
226,6550,10228,16778,0.39039218023602335,Tim Iroegbunam
421,6574,10321,16895,0.3891092039064812,Callum Wilson
131,6550,10356,16906,0.3874364131077724,Tariq Lamptey
512,6397,10120,16517,0.38729793546043473,Michail Antonio
358,6475,10306,16781,0.3858530480901019,Stefan Ortega Moreno
572,6456,10350,16806,0.3841485183862906,Leny Yoro
147,6452,10369,16821,0.3835681588490577,Adam Webster
263,6406,10332,16738,0.38272195005376985,Cameron Burgess
2,6360,10309,16669,0.38154658347831305,Gabriel Fernando de Jesus
301,6325,10266,16591,0.3812307877765053,Caleb Okoli
472,6412,10468,16880,0.3798578199052133,Jack Stephens
65,6307,10327,16634,0.37916315979319465,Enes Ünal
776,2404,3944,6348,0.37870195337114054,Chido Obi-Martin
732,2814,4687,7501,0.3751499800026663,Abdukodir Khusanov
484,6368,10613,16981,0.37500736116836464,Ben Davies
523,6201,10380,16581,0.3739822688619504,Danny Ings
376,6211,10421,16632,0.37343674843674846,Victor Lindelöf
25,6232,10479,16711,0.3729280114894381,Oleksandr Zinchenko
396,6184,10437,16621,0.3720594428734733,Martin Dúbravka
21,6230,10537,16767,0.37156318959861634,Kieran Tierney
696,3823,6538,10361,0.368979828201911,Tyrique George
7,6125,10507,16632,0.36826599326599324,Jorge Luiz Frello Filho
79,6062,10437,16499,0.3674162070428511,Marcos Senesi
174,6123,10556,16679,0.36710833982852686,Roméo Lavia
320,6219,10772,16991,0.3660173032782061,Endo Wataru
457,6039,10556,16595,0.3639047905995782,James Bree
228,6081,10640,16721,0.3636744213862807,Michael Keane
26,5929,10631,16560,0.3580314009661836,Álex Moreno Lopera
305,5849,10654,16503,0.354420408410592,Luke Thomas
731,2687,4927,7614,0.3529025479380089,Andrés García
167,5885,10856,16741,0.3515321665372439,Axel Disasi
69,5809,10737,16546,0.35108183246706154,Daniel Jebbison
325,5859,10844,16703,0.35077530982458244,Caoimhin Kelleher
10,5699,10631,16330,0.3489895897121862,Reiss Nelson
442,5739,10866,16605,0.34561878952122854,Ibrahim Sangaré
570,5616,10665,16281,0.3449419568822554,Abdul Fatawu
486,5629,10846,16475,0.3416691957511381,Radu Drăgușin
189,5591,10826,16417,0.34056161296217335,Wesley Fofana
304,5522,10811,16333,0.338088532419029,Jakub Stolarczyk
506,5501,10784,16285,0.33779551734725205,Micky van de Ven
734,2404,4730,7134,0.33697785253714607,Albert Grønbæk
411,5565,11002,16567,0.33590873423069956,Lewis Miley
590,5546,10982,16528,0.3355517909002904,William Osula
607,5539,11047,16586,0.33395634872784274,Nico O'Reilly
769,2082,4155,6237,0.33381433381433384,Nasser Djiga
166,5486,10990,16476,0.3329691672736101,Kiernan Dewsbury-Hall
80,5357,10881,16238,0.32990516073408055,Luis Sinisterra
610,5372,10932,16304,0.3294896957801766,Mikey Moore
621,5258,10718,15976,0.32911867801702555,João Félix Sequeira
193,5455,11189,16644,0.32774573419851,Cheick Doucouré
542,5375,11175,16550,0.324773413897281,Craig Dawson
473,5256,11060,16316,0.32213777886736944,Ross Stewart
284,5188,10994,16182,0.32060313929056977,Luke Woolfenden
128,5230,11085,16315,0.3205638982531413,Igor Julio dos Santos de Paulo
341,5220,11184,16404,0.3182150694952451,Nathan Aké
363,5193,11153,16346,0.3176924018108406,Kyle Walker
405,5190,11215,16405,0.3163669612922889,Emil Krafth
526,5168,11246,16414,0.31485317411965397,Luis Guilherme Lira dos Santos
463,5132,11206,16338,0.31411433467988736,Adam Lallana
277,5004,11191,16195,0.308984254399506,Massimo Luongo
362,5031,11340,16371,0.3073117097306212,John Stones
196,5118,11623,16741,0.30571650439041875,Nathaniel Clyne
68,4938,11306,16244,0.30398916523023883,James Hill
581,4886,11430,16316,0.2994606521206178,Filip Jørgensen
592,4794,11272,16066,0.2983941242375202,Julián Araujo Zúñiga
156,4840,11428,16268,0.2975165970002459,Armando Broja
584,4772,11305,16077,0.29682154630839086,Ben Brereton Díaz
234,4773,11463,16236,0.29397634885439766,Nathan Patterson
674,3668,8862,12530,0.2927374301675978,Paris Maghoma
333,4856,11840,16696,0.2908481073310973,Jarell Quansah
214,4789,11729,16518,0.28992614117931953,Jeffrey Schlupp
307,4764,11735,16499,0.2887447724104491,Jannik Vestergaard
97,4656,11565,16221,0.28703532457924913,Yunus Emre Konak
429,4646,11569,16215,0.2865248226950355,Danilo dos Santos de Oliveira
302,4631,11535,16166,0.2864654212544847,Ricardo Barbosa Pereira
488,4577,11489,16066,0.28488733972364,Fraser Forster
254,4559,11457,16016,0.28465284715284717,Harrison Reed
655,4160,10737,14897,0.2792508558770222,Carlos Roberto Forbs Borges
393,4518,11726,16244,0.2781334646638759,Sven Botman
391,4478,11658,16136,0.27751611303916707,Miguel Almirón Rejala
31,4577,11921,16498,0.2774275669778155,Emiliano Buendía Stati
583,4424,11583,16007,0.2763790841506841,Conor Townsend
204,4436,11638,16074,0.27597362199825803,Sam Johnstone
35,4525,11891,16416,0.27564571150097467,Diego Carlos Santos Silva
76,4434,11653,16087,0.2756262820911295,Philip Billing
576,4408,11707,16115,0.2735339745578653,Andy Irving
404,4404,11766,16170,0.27235621521335807,Lloyd Kelly
586,4339,11644,15983,0.27147594318963897,Jorge Cuenca Barreno
107,4329,11789,16118,0.2685817098895645,Igor Thiago Nascimento Rodrigues
84,4296,11740,16036,0.2678972312297331,Mark Travers
322,4357,12002,16359,0.2663365731401675,Joe Gomez
604,4251,11785,16036,0.2650910451484161,Josh King
785,1293,3601,4894,0.2642010625255415,Claudio Echeverri
795,813,2337,3150,0.2580952380952381,Harry Howell
365,4108,11830,15938,0.25774877650897227,Antony Matheus dos Santos
477,4109,11922,16031,0.25631588796706384,Nathan Wood-Gordon
628,3878,11333,15211,0.2549470777726645,Ferdi Kadioglu
371,4060,11878,15938,0.2547371062868616,Jonny Evans
260,3974,11898,15872,0.2503780241935484,Ali Al-Hamadi
387,3990,12118,16108,0.24770300471815246,Luke Shaw
636,3816,11630,15446,0.24705425352842159,Federico Chiesa
763,1504,4590,6094,0.24680013127666559,Eiran Cashin
713,1913,5905,7818,0.24469173701713992,Julio Soler
160,3999,12378,16377,0.24418391646821763,Ben Chilwell
283,3857,11983,15840,0.24349747474747474,Christian Walton
697,2419,7517,9936,0.24345813204508857,Josh Acheampong
687,2678,8357,11035,0.2426823742637064,Ben Winterburn
469,3857,12084,15941,0.24195470798569726,Alex McCarthy
397,3866,12195,16061,0.24070730340576552,Ryan Fraser
184,3835,12100,15935,0.2406652023846878,Renato Palma Veiga
132,3856,12256,16112,0.23932472691161866,Solly March
153,3808,12134,15942,0.23886588884707063,Benoît Badiashile
179,3819,12177,15996,0.23874718679669918,Mykhailo Mudryk
598,3873,12398,16271,0.23803085243685085,Lamare Bogarde
632,3544,11440,14984,0.23651895355045383,Chiedozie Ogbene
796,728,2357,3085,0.23598055105348462,Olabade Aluko
100,3720,12129,15849,0.23471512398258565,Ben Mee
198,3711,12120,15831,0.23441349251468638,Odsonne Edouard
733,1648,5401,7049,0.2337920272379061,Vitor de Oliveira Nunes dos Reis
784,1192,3963,5155,0.2312318137730359,Mateus Mané
613,3636,12241,15877,0.22901051835989167,Toby Collyer
475,3648,12385,16033,0.22753071789434293,Charlie Taylor
425,3581,12293,15874,0.22558901348116417,Willy Boly
466,3563,12269,15832,0.22505053057099544,Joe Lumley
134,3563,12291,15854,0.22473823640721585,James Milner
266,3531,12316,15847,0.22281819902820724,Harry Clarke
536,3523,12308,15831,0.2225380582401617,Daniel Bentley
221,3526,12374,15900,0.22176100628930817,Séamus Coleman
719,1716,6034,7750,0.22141935483870967,Joachim Kayi-Sanda
670,2786,9813,12599,0.22112866100484166,Harry Amass
781,1230,4406,5636,0.21823988644428674,Shumaira Mheuka
500,3440,12336,15776,0.21805273833671399,Dane Scarlett
444,3444,12372,15816,0.21775417298937785,Harry Toffolo
137,3426,12453,15879,0.2157566597392783,Jakub Moder
73,3380,12495,15875,0.21291338582677166,Norberto Murara Neto
698,2094,7775,9869,0.21217955213294154,Divin Mubama
50,3400,12663,16063,0.2116665629085476,Kosta Nedeljković
92,3337,12522,15859,0.21041679803266283,Rico Henry
367,3309,12476,15785,0.20962939499524866,Altay Bayindir
51,3370,12743,16113,0.20914789300564762,Robin Olsen
558,3313,12539,15852,0.2089957103204643,Yerson Mosquera
634,3125,11921,15046,0.20769639771367807,Gustavo Nunes Fernandes Gomes
287,3265,12459,15724,0.20764436530145,Hamza Choudhury
208,3343,12841,16184,0.2065620365793376,Matheus França de Oliveira
701,2016,7765,9781,0.20611389428483795,Lewis Orford
343,3276,12673,15949,0.2054047275691266,Oscar Bobb
726,1527,5922,7449,0.2049939589206605,Woyo Coulibaly
142,3229,12538,15767,0.20479482463372867,Jason Steele
59,3216,12520,15736,0.20437214031520082,Max Aarons
777,1219,4781,6000,0.20316666666666666,Tyler Fredricson
360,3226,12656,15882,0.20312303236368215,Rodrigo 'Rodri' Hernandez
771,1231,4860,6091,0.2021014611722213,Mathis Amougou
658,2943,11650,14593,0.20167203453710683,Ayden Heaven
237,3162,12647,15809,0.20001265102156998,Youssef Ramalho Chermiti
178,3131,12661,15792,0.19826494427558258,Marc Guiu Paz
728,1433,5844,7277,0.19692180843754295,Zain Silcott-Duberry
96,3079,12648,15727,0.1957779614675399,Kim Ji-soo
258,3074,12631,15705,0.19573384272524674,Carlos Vinícius Alves Morais
609,3072,12647,15719,0.19543227940708696,Will Lankshear
561,3056,12690,15746,0.19408103645370253,Pedro Cardoso de Lima
707,1638,6845,8483,0.193092066485913,Remy Rees-Dottin
416,3003,12791,15794,0.19013549449157907,Matt Targett
124,2973,12743,15716,0.18917027233392722,Billy Gilmour
496,2935,12705,15640,0.18765984654731457,Sergio Reguilón
109,2916,12746,15662,0.18618311837568638,Hákon Valdimarsson
603,2917,12767,15684,0.1859857179290997,Harrison Armstrong
672,2258,9943,12201,0.18506679780345872,Jahmai Simpson-Pusey
428,2906,12814,15720,0.18486005089058524,Eric da Silva Moreira
456,2897,12790,15687,0.18467520877159432,Armel Bella-Kotchap
379,2889,12763,15652,0.1845770508561206,Tyrell Malacia
664,2513,11159,13672,0.183806319485079,Alfie Pond
308,2866,12765,15631,0.1833535922205873,Danny Ward
699,1762,7888,9650,0.18259067357512954,Alfie Dorrington
562,2836,12815,15651,0.1812024790748195,Daniel Castelo Podence
102,2828,12799,15627,0.1809688359889934,Frank Onyeka
381,2799,12792,15591,0.17952664999037907,Scott McTominay
605,2791,12802,15593,0.17899057269287502,Martial Godo
22,2818,12927,15745,0.17897745315973324,Tomiyasu Takehiro
643,2639,12223,14862,0.17756694926658592,Kaelan Casey
271,2749,12778,15527,0.1770464352418368,Marcus Myers-Harness
665,2327,11016,13343,0.17439856104324364,Nathan Butler-Oyedeji
649,2520,11935,14455,0.17433414043583534,Jayden Meghoma
602,2718,12884,15602,0.17420843481604922,Ryan Trevitt
666,2373,11254,13627,0.17413957584207823,Caleb Kporha
646,2648,12559,15207,0.17413033471427633,Asher Agbinone
141,2726,12951,15677,0.17388530968935384,Jeremy Sarmiento Morante
515,2680,12894,15574,0.17208167458584822,Maxwel Cornet
537,2683,12942,15625,0.171712,Francisco Jorge Tomás Oliveira
534,2685,12981,15666,0.17139027192646494,Boubacar Traoré
556,2674,12980,15654,0.17081896001022104,Tom King
479,2655,12948,15603,0.17015958469525092,Brandon Austin
451,2647,12930,15577,0.1699300250369134,Samuel Amo-Ameyaw
606,2635,12914,15549,0.16946427422985402,Will Alves
292,2639,12937,15576,0.16942732408834105,Michael Golding
460,2640,12961,15601,0.16921992179988463,Ronnie Edwards
256,2609,12893,15502,0.16830086440459296,Jay Stansfield
225,2623,12988,15611,0.16802254820319007,Mason Holgate
459,2613,12953,15566,0.16786586149299756,Samuel Edozie
269,2599,12893,15492,0.16776400722953783,George Edmundson
660,2377,11886,14263,0.16665498142045854,Vítezslav Jaros
709,1472,7595,9067,0.16234697253777436,Jayden Danns
215,2566,13373,15939,0.16098876968442186,Joel Ward
195,2519,13384,15903,0.1583977865811482,Chadi Riad Dnanou
627,2377,12814,15191,0.15647422816141135,Roman Dixon
715,1095,6591,7686,0.14246682279469164,Ben Godfrey
